murder disguised as suicide	1.0
head crushing	1.0
trial by combat	1.0
intrigue	1.0
betrayal	1.0
river	1.0
crushed head	1.0
female nudity	0.5
fight to the death	Non
beetle	Non
tear on cheek	Non
inquiry	Non
bare breasts	Non
massacre	Non
woman burping	Non
snake in episode title	Non
subservient male	Non
sewing	Non
bathing in a river	Non
eyes gouged out	Non
