walk of shame	1.0
public nudity	1.0
dragon	1.0
man flashing	1.0
woman bathing a woman	1.0
female full frontal nudity	1.0
punched in the stomach	Non
punctuation in title	Non
male nudity	Non
female nudity	Non
male full frontal nudity	Non
pubic hair	Non
male pubic hair	Non
female pubic hair	Non
escape	Non
suicide	Non
nosebleed	Non
assassination	Non
stabbed in the belly	Non
woman crying	Non
spitting on someone	Non
woman flashing	Non
bleeding foot	Non
woman's hair cut off	Non
trip and fall	Non
finger ring	Non
scenic beauty	Non
bare chested male	Non
ketch	Non
vengeance	Non
throat cut	Non
stabbed multiple times	Non
licking a wound	Non
man hits girl	Non
fall to death	Non
massacre	Non
envelopment maneuver	Non
army on the march	Non
horse drawn wagon	Non
corpse hanging by the neck in public	Non
winter camp	Non
icicle	Non
death of recurring character	Non
hair cut off	Non
atonement	Non
confession	Non
poison	Non
child abuser	Non
throat slitting	Non
stabbed in the eye	Non
death of king	Non
jump from height	Non
battle	Non
suicide by hanging	Non
desertion	Non
apostrophe in episode title	Non
