dragon	1.0
undead	1.0
wolf	1.0
night watch	1.0
fire breathing dragon	1.0
snow	1.0
coin	1.0
magic	1.0
wedding	1.0
broken engagement	1.0
stabbed in the stomach	Non
king	Non
wildling	Non
wight	Non
marriage	Non
sword fight	Non
entombed alive	Non
bare chested male	Non
burning a body	Non
talking to one's dead husband	Non
immolation	Non
chained to a wall	Non
man holding a baby	Non
carrying a torch	Non
mercy killing	Non
facial cut	Non
gazing at a fire	Non
corpse hanging from a tree	Non
bare breasts	Non
award ceremony	Non
head bandage	Non
defecating horse	Non
sickle	Non
dragonling	Non
female nudity	Non
burning a dead body	Non
burning man	Non
strangulation	Non
wedding ceremony	Non
luxury brothel	Non
prostitute	Non
cleavage	Non
two word episode title	Non
prince	Non
dwarf	Non
potion	Non
queen	Non
horse	Non
blizzard	Non
stabbed with sword	Non
bound in chains	Non
doppelganger	Non
vision of dead person	Non
burned out castle	Non
scarred face	Non
war cry	Non
stabbed with a spear	Non
grabbed by the throat	Non
black eye	Non
boy king	Non
close up of eye	Non
