brother brother relationship	1.0
king	1.0
deserter	1.0
man undressing a woman	1.0
body parts arranged in a pattern	1.0
woman wearing a sheer dress	1.0
beheaded with a sword	1.0
execution	1.0
decapitated head	1.0
violence	1.0
sword	1.0
undead	1.0
beheading	1.0
illegitimate son	1.0
arrow	1.0
female rear nudity	0.5
horseback chase	Non
cutting hair	Non
falling from height	Non
sister	Non
running for one's life	Non
stag	Non
animal carcass	Non
petrified egg	Non
dragon egg	Non
wolf	Non
tolling bell	Non
brother sister incest	Non
brother sister incestuous sex	Non
brother sister sex	Non
brother in love with sister	Non
sister in love with brother	Non
adolescent	Non
fall	Non
corporal punishment	Non
bully	Non
public humiliation	Non
punishment	Non
undressing	Non
trial	Non
loyalty	Non
male rear nudity	Non
paternity	Non
castle	Non
queen	Non
little sister	Non
female star appears nude	Non
tear on cheek	Non
gift	Non
book	Non
cutting ponytail	Non
disembowelment	Non
sex in public	Non
dancing girl	Non
snake	Non
looking at the ocean	Non
throwing food	Non
close up of bare breast	Non
brother undressing sister	Non
cowgirl sex position	Non
feather	Non
bastard	Non
kneeling before a king	Non
climbing a wall	Non
knight in armor	Non
procession	Non
raven	Non
lying in state	Non
dier wolf	Non
stag carcass	Non
showing off	Non
archery	Non
pokies	Non
foot chase	Non
running for your life	Non
incest	Non
breasts	Non
box full of snakes	Non
woman in a hot bath	Non
vox pop	Non
discovering a dead body	Non
mutilated corpse	Non
frozen corpse	Non
ritual	Non
rascal	Non
duel	Non
kneeling	Non
knife	Non
boy	Non
hot bath	Non
suit of armor	Non
climbing down a wall	Non
bull's eye	Non
carcass	Non
moose	Non
target shooting	Non
laughter	Non
severed head	Non
spear	Non
helmet	Non
soldier	Non
armor	Non
brutality	Non
dragon	Non
prince	Non
wedding	Non
egg	Non
caught having sex	Non
feast	Non
decapitation	Non
doggystyle sex	0.0
male nudity	0.0
sex scene	0.0
bare butt	0.0
female nudity	0.0
bare chested male	0.0
close up of breasts	0.0
fellatio	0.0
woman removing a man's boots	0.0
female full frontal nudity	0.0
