wedding	1.0
mercenary	1.0
sex scene	1.0
severed head	1.0
priestess	1.0
drinking wine	1.0
forced marriage	1.0
leech	1.0
learning to read	1.0
drunkenness	1.0
title directed by female	Non
ice monster	Non
murder of crows	Non
face on a tree	Non
drunken man	Non
bound hand and foot	Non
heterosexual bondage	Non
knife held to throat	Non
copper bathtub	Non
woman bathing a woman	Non
drawing lots	Non
square coin	Non
baby name	Non
woman undressing a man	Non
woman undressing for a man	Non
cleavage	Non
bare chested male	Non
scantily clad female	Non
woman in bathtub	Non
female frontal nudity	Non
female rear nudity	Non
breast fondling	Non
cowgirl sex position	Non
coitus	Non
covered female frontal nudity	Non
bare butt	Non
bare breasts	Non
topless female nudity	Non
female nudity	Non
nudity	Non
public humiliation	Non
prison cell	Non
release from prison	Non
prisoner	Non
beach	Non
undead	Non
raven	Non
forest	Non
mirror	Non
horse	Non
two word episode title	Non
protective male	Non
reading	Non
wine	Non
cloak	Non
ritual	Non
tied to a bed	Non
reading aloud	Non
woman on top	Non
unconsummated marriage	Non
undressing	Non
child bride	Non
wedding reception	Non
wedding ceremony	Non
rock	Non
