shot with a crossbow	1.0
torture	1.0
climbing a wall	1.0
human target	Non
murdered by king	Non
cutting lifeline	Non
avalanche	Non
blizzard	Non
ice climbing	Non
blowing a horn	Non
rock climbing	Non
cave	Non
scar	Non
target practice	Non
archery	Non
skinning rabbit	Non
campfire	Non
finger cut off	Non
fall from height	Non
cliff	Non
