returning home	1.0
paying off a debt	1.0
reunited sisters	1.0
gold shipment	Non
man in a wheelchair	Non
dagger	Non
cave carving	Non
torch	Non
sparring	Non
call to arms	Non
pike	Non
cavalry charge	Non
riding a dragon	Non
immolation	Non
firing arrow from horseback	Non
archer	Non
volley of arrows	Non
fire breathing dragon	Non
ballista	Non
bag of gold	Non
prosthetic hand	Non
combat	Non
