wildfire	1.0
snow	1.0
trial	1.0
king	1.0
queen	1.0
home	1.0
mad queen	1.0
uncle	1.0
pie	1.0
counselor	1.0
dwarf	1.0
crying	1.0
library	1.0
baby	1.0
ship	1.0
crown	1.0
wine	1.0
tunnel	1.0
candle	1.0
assassination	1.0
running	1.0
torch	1.0
knife	1.0
priest	1.0
stabbed repeatedly	Non
stairway	Non
wax seal	Non
sealed letter	Non
lord	Non
god	Non
speech	Non
dragon	Non
farewell	Non
catacomb	Non
armada	Non
caravel	Non
brig	Non
death in childbirth	Non
declaring allegiance	Non
newborn	Non
human meat pie	Non
throat cut	Non
banished	Non
toy	Non
mass murder	Non
bureaucrat	Non
fall to death	Non
white raven	Non
climbing out a window	Non
revenge	Non
torture	Non
wine splashed in face	Non
fire bomb	Non
green fire	Non
time bomb	Non
septagram	Non
child assassin	Non
decorative scarring	Non
confession	Non
morals trial	Non
coronation	Non
throne room	Non
teen suicide	Non
suicide	Non
betrayed by mother	Non
gay	Non
flag	Non
white walker	Non
horse	Non
leaf	Non
needle	Non
pyramid	Non
body armor	Non
faith	Non
yelling	Non
fat man	Non
smiling	Non
forest	Non
dinner	Non
sword	Non
beard	Non
kingdom	Non
fantasy world	Non
death of son	Non
