battle	1.0
castle	1.0
night watch	1.0
snow	1.0
mammoth	1.0
giant	1.0
imax version	1.0
flaming arrow	1.0
barrel	1.0
first kiss	1.0
death of lover	1.0
owl	1.0
violence	1.0
killed with a ball peen hammer	Non
crossbow	Non
ice climbing	Non
impaled with an arrow	Non
dodging an arrow	Non
archer	Non
invasion	Non
signal fire	Non
forest fire	Non
elevator	Non
shot point blank	Non
horn	Non
blowing horn	Non
climbing up a wall	Non
climbing a wall	Non
hammer blow to the head	Non
hit on the head with a hammer	Non
hammer	Non
kiss	Non
hiding place	Non
hiding	Non
death by hammer	Non
siege	Non
swordplay	Non
