nightmare	1.0
snowy landscape	1.0
theft	1.0
loyalty	1.0
abuse	1.0
cage	1.0
burned body	1.0
virginity	1.0
menstrual blood	1.0
menarche	1.0
massacre	Non
candle	Non
bound in chains	Non
throat cut	Non
vault	Non
body painting	Non
strangled with a chain	Non
memories	Non
best day of my life	Non
first menses	Non
locked in a cell	Non
castle ruins	Non
wolfsbane	Non
masked woman	Non
male rear nudity	Non
bare butt	Non
crying woman	Non
blood	Non
man refusing sex	Non
refusing sex	Non
held captive	Non
talking about sex	Non
sexual innuendo	Non
touching breasts	Non
manhunt	Non
throat slitting	Non
doppelganger	Non
body hanging from a rope	Non
jail	Non
execution	Non
fire	Non
corporal punishment	Non
prison	Non
double child murder	Non
virgin	Non
male virgin	Non
menstruation	Non
erection	0.0
