snow	1.0
ship	1.0
fight	1.0
escape	1.0
sword fight	1.0
sword	1.0
dungeon	1.0
coin	1.0
iron	1.0
cave	1.0
tree	1.0
battle	1.0
murder	1.0
incest	1.0
breasts	1.0
woman strangled to death	1.0
death of lover	1.0
death of brother	1.0
skeleton	1.0
intrigue	1.0
undead	1.0
female knight	1.0
death of father	1.0
title spoken by character	1.0
woman naked under covers	0.5
female nudity	0.5
girl dressed as a boy	Non
hug	Non
woman bites a man	Non
woman fights a man	Non
pain	Non
woman wearing armor	Non
hiding	Non
reloading a bow	Non
animate skeleton	Non
patricide	Non
woman in bed	Non
female warrior	Non
crate	Non
crossbow	Non
surrender	Non
man sitting on a toilet	Non
strangled with a chain	Non
left to die	Non
terms of surrender	Non
kiss	Non
imax version	Non
returning character killed off	Non
horseback riding	Non
horse	Non
squire	Non
woman biting a man's ear	Non
stabbed to death	Non
magical tree	Non
confession	Non
toilet	Non
sitting on a toilet	Non
waterfall	Non
box	Non
burning a dead body	Non
funeral pyre	Non
kiss on the cheek	Non
strangulation	Non
stabbing	Non
death by strangulation	Non
magic	Non
cavalry	Non
bare butt	0.0
