trial	1.0
murder trial	1.0
betrayal	1.0
intrigue	1.0
bank	1.0
goat	1.0
cage	1.0
dragon	1.0
female nudity	0.5
rescue	Non
supplicant	Non
brainwashed	Non
rant	Non
goatherd	Non
bare chested male	Non
caged animal	Non
battle axe	Non
grappling hook	Non
rowboat	Non
cowgirl sex position	Non
gold coin	Non
public nudity	Non
public bath	Non
galley	Non
giganitic statue	Non
kennel	Non
dog	Non
asexual	Non
testimony	Non
judge	Non
bathtub	Non
caged human	Non
biting	0.0
woman on top	0.0
