intrigue	1.0
neck wound	1.0
mercy killing	1.0
death by falling	1.0
bare breasts	0.5
pie	0.5
female nudity	0.5
stomach wound	Non
inn	Non
husband murders wife	Non
jealousy	Non
unwelcome kiss	Non
tantrum	Non
woman in a bath	Non
man undressing for a woman	Non
wildflower	Non
snow castle	Non
bounty hunter	Non
steak and kidney pie	Non
disembowelment	Non
impaled by a sword	Non
stabbed in the heart	Non
entrails	Non
face slap	Non
undressing	Non
bathtub	Non
snow sculpture	Non
bread	Non
bird in episode title	0.0
animal in episode title	0.0
kidney pie	0.0
male rear nudity	0.0
male nudity	0.0
