bad haircut	1.0
junkyard	1.0
computer keyboard	Non
nosebleed	Non
hug	Non
petting an animal	Non
reunion	Non
cgi animal in live action title	Non
bow and arrow	Non
fireplace	Non
tiger	Non
handshake	Non
stabbed with a glass shard	Non
thrown into a pit	Non
man in undershirt	Non
hand wound	Non
woman wearing a flannel shirt	Non
junk art	Non
scrapyard	Non
standoff	Non
