season finale	1.0
chimney	1.0
calling someone an asshole	1.0
decapitation	1.0
solar panel	Non
love quadrangle	Non
blizzard	Non
contemplating suicide	Non
stabbed with icicle	Non
stabbed in the eye	Non
stabbed to death	Non
snowball fight	Non
episode title spoken by character	Non
close up of mouth	Non
pavillion	Non
winter	Non
birthday card	Non
charter	Non
body armor	Non
horseback riding	Non
crossbow bolt to the head	Non
covered wagon	Non
wagon train	Non
walking in the woods	Non
grieving parent	Non
frozen lake	Non
grieving mother	Non
way station	Non
calling someone kiddo	Non
fireplace	Non
reference to christmas	Non
snowstorm	Non
walking in a snowstorm	Non
border crossing	Non
bandana over mouth	Non
stabbed in the head	Non
kicked in the head	Non
overhead camera shot	Non
black man white woman romance	Non
black man white woman marriage	Non
black man white woman relationship	Non
reference to rick grimes	Non
reference to shakespeare's julius caesar	Non
dog	Non
quoting shakespeare's richard iii	Non
quoting shakespeare's julius caesar	Non
directed by greg nicotero	Non
quoting shakespeare	0.0
shot in the head with an arrow	0.0
crossbow	0.0
wordplay	0.0
