close up of eyes	1.0
death of loved one	1.0
beaten to death	1.0
eeny meeny miny moe	1.0
nonlinear timeline	1.0
hit with a baseball bat	1.0
flashback	1.0
recreational vehicle	1.0
returning character killed off	1.0
murder	1.0
death of major character	1.0
violence	1.0
blood	1.0
pregnant woman	1.0
shot in the chest	1.0
death of husband	1.0
punched in the face	1.0
subjective camera	1.0
hanged man	1.0
head bashed in	1.0
character repeating someone else's dialogue	1.0
hatchet	1.0
death of friend	1.0
fantasy sequence	0.3333333333333333
hit in the head with a baseball bat	Non
bludgeoned to death	Non
child in danger	Non
crying	Non
villain	Non
threatened with a baseball bat	Non
directed by greg nicotero	Non
man crying	Non
long dinner table	Non
family dinner	Non
hugging one's friend	Non
loss of husband	Non
loss of friend	Non
loss of loved one	Non
snapping fingers	Non
severed head	Non
machine gun	Non
death of main character	Non
calling someone an asshole	Non
threatened with a crossbow	Non
calling someone sweetheart	Non
crossbow	Non
psychopath	Non
blood spatter	Non
fog	Non
hit by an rv	Non
hit by a recreational vehicle	Non
threatened with a gun	Non
threaten to kill	Non
death threat	Non
threatened with a hatchet	Non
baseball bat	Non
slow motion scene	0.0
stabbed to death	0.0
stabbed in the head	0.0
decapitation	0.0
head ripped off	0.0
shot to death	0.0
shot in the forehead	0.0
shot in the head	0.0
lens flare	0.0
smoke	0.0
black and white scene	0.0
hit by a car	0.0
