bitten by a zombie	1.0
flash forward	1.0
manhole	1.0
digging a grave	1.0
one eyed boy	Non
loss of son	Non
loss of loved one	Non
woman wearing a tank top	Non
shot in the head	Non
looking at oneself in a mirror	Non
montage with pop song	Non
rocking chair	Non
high five	Non
polaroid	Non
polaroid camera	Non
taking a selfie	Non
view through rifle scope	Non
body armor	Non
stabbed in the temple	Non
hiding behind a tree	Non
stabbed in the head	Non
goodbye letter	Non
fire extinguisher	Non
pickup truck	Non
walkie talkie	Non
main character dies	Non
child kills an adult	Non
stabbed through the neck	Non
dying man	Non
father son talk	Non
offscreen killing	Non
off screen suicide	Non
tree planting	Non
letter writing	Non
directed by greg nicotero	Non
father son relationship	Non
brother sister relationship	Non
white man black woman romance	Non
white man black woman relationship	Non
death of son	Non
text of letter on screen	0.0
