character name in episode title	1.0
woman wearing only an apron	1.0
shot with a bazooka	1.0
hit by a garbage truck	1.0
microwave	Non
body armor	Non
cleaning a gun	Non
voice over letter	Non
man wearing only an apron	Non
man wearing an apron	Non
woman wearing an apron	Non
locked in a shipping container	Non
scrapyard	Non
pocket watch	Non
one eyed boy	Non
child in peril	Non
calling someone stupid	Non
hit in the face with a rifle butt	Non
hit with a rifle butt	Non
threatened with a gun	Non
walking in the woods	Non
stabbed in the neck	Non
stabbed in the throat	Non
tennis ball	Non
kicking a tennis ball	Non
woman wearing a tank top	Non
kicking a ball	Non
rpg	Non
firing an rpg	Non
bazooka	Non
garbage truck	Non
car hit by a truck	Non
hit by a truck	Non
opera music	Non
woman holding a shotgun	Non
identity crisis	Non
view through rifle scope	Non
bare chested male	Non
asking to be left alone	Non
double bitted battleaxe	Non
