gate	1.0
broken ankle	1.0
license plate	1.0
forest	1.0
suspicion	1.0
flare gun	1.0
photograph	1.0
barn	Non
gay	Non
flare gun as weapon	Non
close up of eyes	Non
character says i love you	Non
gay kiss	Non
shot in the eye	Non
beaten to death	Non
head bashed in	Non
shot to death	Non
shot in the forehead	Non
shot in the head	Non
hit with a car door	Non
severed hand	Non
severed arm	Non
hit by a car	Non
recreational vehicle	Non
arm ripped off	Non
stabbed to death	Non
stabbed in the forehead	Non
stabbed in the head	Non
punched in the face	Non
character repeating someone else's dialogue	Non
baby	Non
