mortuary	1.0
fog	1.0
kiss	1.0
dog	1.0
twisted ankle	1.0
writing in blood	1.0
piano playing	1.0
corpse	1.0
train tracks	1.0
one word episode title	Non
kidnapping	Non
impalement	Non
shot in the forehead	Non
peanut butter	Non
carrying someone	Non
kicked in the face	Non
disembowelment	Non
stabbed in the forehead	Non
singing	Non
casket	Non
cemetery	Non
shot in the face	Non
knife	Non
stabbed in the head	Non
stabbed to death	Non
head bashed in	Non
shot to death	Non
shot in the head	Non
flashback	Non
motorcycle	Non
machete	Non
slow motion scene	Non
forest	Non
title spoken by character	Non
