crystal meth	1.0
high school	1.0
chemotherapy	1.0
building explosion	1.0
mercury fulminate	1.0
putting out a cigarette on one's tongue	1.0
shaving head	1.0
bare chested male	1.0
male in a shower	1.0
hair falling out	1.0
texas hold 'em	1.0
american flag	1.0
raising a flag	1.0
bag of money	1.0
safe	1.0
security camera	1.0
stock room	1.0
volumetric flask	1.0
shaved head	1.0
hair loss	1.0
drug dealer	1.0
gas mask	Non
vomiting	Non
erlenmeyer flask	Non
boiling flask	Non
indian reservation	Non
graduated cylinder	Non
wad of money	Non
laundromat	Non
personal check	Non
making methamphetamine	Non
funnel	Non
recreational vehicle	Non
man with lung cancer	Non
lawn chair	Non
beaker	Non
chemistry class	Non
male vomiting	Non
time lapse photography	Non
post dated check	Non
selling drugs	Non
silent partner	Non
extortion	Non
montage	Non
janitor	Non
title directed by female	Non
punctuation in title	Non
apostrophe in title	Non
co worker	Non
shower	Non
money	Non
theft	Non
support group	Non
revenge	Non
investigation	Non
hospital	Non
explosion	Non
