shot in the back of one's head	1.0
new hampshire	1.0
attempted escape	1.0
dungeon	1.0
drinking whisky	1.0
watching tv	1.0
character appears on a tv talk show	1.0
pay phone	Non
new identity	Non
cabin	Non
calling someone a psycho	Non
chemotherapy	Non
shot point blank	Non
roommate	Non
picking a handcuff lock	Non
scotch whisky	Non
local bar	Non
reference to the new york times	Non
telephone off hook	Non
drinking at bar	Non
dimple pinch whisky	Non
wanting father to die	Non
hanging up on someone	Non
box of money	Non
principal's office	Non
telling someone to shut up	Non
telephone conversation	Non
father son conflict	Non
parcel	Non
wedding ring	Non
playing cards	Non
secluded cabin	Non
drip	Non
cancer treatment	Non
gate	Non
newspaper	Non
glasses	Non
reference to youtube	Non
gun with silencer	Non
murder of a woman	Non
bound and gagged	Non
trying to escape	Non
held captive	Non
escape from handcuffs	Non
ben and jerry's ice cream	Non
pork pie hat	Non
cash	Non
barrel	Non
parka	Non
reference to costco	Non
snowy landscape	Non
cafe	Non
witness intimidation	Non
baby daughter	Non
baby girl	Non
holding one's hand over someone's mouth	Non
balaclava	Non
cigarette smoking	Non
coughing	Non
vacuum cleaner salesman	Non
lawyer client relationship	Non
corrupt lawyer	Non
lawyer	Non
watching dvd	Non
paper clip	Non
photograph	Non
reference to john dillinger	Non
