reference to heisenberg	1.0
listening through the wall	1.0
worker rehired	1.0
reference to derek jeter	1.0
skymall catalog	1.0
foreign language episode title	Non
unwanted person	Non
language barrier	Non
leg blown off	Non
bomb	Non
tortoise	Non
binoculars	Non
stakeout	Non
orchid	Non
informant	Non
severed head	Non
lighting a cigar	Non
reference to sun tzu	Non
knocking on door	Non
hiding place	Non
drop ceiling	Non
mariachi band	Non
