airport	1.0
sex in a closet	1.0
morgue	1.0
car accident	1.0
crystal meth	1.0
crying	1.0
scream	1.0
hit by a bus	1.0
puerto rican american	Non
christmas	Non
closeted homosexual	Non
running	Non
party	Non
secret	Non
christmas eve	Non
bus	Non
singing in a car	Non
multiple personality disorder	Non
gay policeman	Non
sex addiction	Non
gay kiss	Non
kiss	Non
year 2000	Non
speeding vehicle	Non
suicide	Non
flashback	Non
daydream	Non
indifference	Non
comfort	Non
gratitude	Non
methamphetamine	Non
wedding ring	Non
shame	Non
request	Non
new car	Non
lecture	Non
insult	Non
grudge	Non
criticism	Non
support	Non
supermarket	Non
rudeness	Non
rotten food	Non
pizza	Non
photograph	Non
jealousy	Non
island	Non
guilt	Non
embalming	Non
canteloupe	Non
boating	Non
blown cover	Non
argument	Non
anger	Non
tradition	Non
selfishness	Non
salt	Non
rejection	Non
regret	Non
hearse	Non
ghost	Non
ghost in mirror	Non
dirt	Non
confession	Non
cigarette smoking	Non
cemetery	Non
business rivalry	Non
burial	Non
bad habit	Non
adulterous wife	Non
