transceiver	1.0
polar bear	1.0
handcuffs	1.0
heroin	1.0
plane crash	1.0
comic book	1.0
beach	1.0
dialect	Non
directed by j.j. abrams	Non
written by j.j. abrams	Non
produced by j.j. abrams	Non
survivor	Non
island	Non
distress signal	Non
survival	Non
dog	Non
attack	Non
friends who live together	Non
fight	Non
mayday	Non
bloody face	Non
oceanic flight	Non
flashback	Non
fainting	Non
scratch	Non
blood	Non
gun	Non
gunfire	Non
running	Non
screaming	Non
eating	Non
jungle	Non
fisherman	Non
ex military	Non
medical doctor	Non
shaking hands	Non
laughing	Non
swimming in underwear	Non
airplane crash	Non
labrador retriever	Non
mysterious island	Non
