key card	1.0
watching someone die	1.0
ventilation	1.0
gun with silencer	1.0
reference to pandora's box	1.0
nerve gas	1.0
episode title ends with a period	Non
time in episode title	Non
murder of a security guard	Non
punctuation in episode title	Non
period in episode title	Non
number in episode title	Non
hyphen in episode title	Non
digit in episode title	Non
colon in episode title	Non
father daughter relationship	Non
gassed to death	Non
shot while trying to escape	Non
trying to escape	Non
countdown timer	Non
sealed door	Non
situation room	Non
death of a co worker	Non
ends with death	Non
alarm	Non
shooting surveillance camera	Non
holding room	Non
security breach	Non
lockdown	Non
interrogation room	Non
stabbed to death	Non
clinical psychologist	Non
father and daughter reunited	Non
u.s. vice president	Non
chemical weapon	Non
husband wife relationship	Non
blonde woman	Non
first lady	Non
chief of staff	Non
hidden valley ventura county california	Non
presidential retreat	Non
