religious	1.0
insult	1.0
christian	1.0
saying grace	1.0
prayer	1.0
weaving	1.0
fish	1.0
goldfish	1.0
loom	1.0
fired from the job	1.0
animal in episode title	Non
fish in episode title	Non
cobbler the food	Non
new boss	Non
experiment	Non
woman wearing a red dress	Non
door shut in face	Non
multi vitamin	Non
scrambled eggs	Non
temporal paradox	Non
time travel	Non
bazinga	Non
adhd	Non
attention deficit hyperactivity disorder	Non
escort	Non
driving	Non
car	Non
apology	Non
cooking	Non
breakfast	Non
egg	Non
supermarket	Non
red dress	Non
poncho	Non
grocery shopping	Non
buffet	Non
expression taken literally	Non
