scavenger hunt	1.0
singing in a car	1.0
reference to neil diamond	1.0
reference to weird al yankovic	1.0
reference to eminem	1.0
reference to the beatles	1.0
choosing a team member	Non
whispering into someone's ear	Non
geology laboratory	Non
reference to the beetles	Non
ipod	Non
geocoordinates	Non
poster	Non
sliding down an elevator cable	Non
laundry room	Non
reference to princeton university	Non
reference to batman	Non
reference to the rolling stones	Non
bowling alley	Non
comic book shop owner	Non
bickering	Non
bickering couple	Non
coin	Non
karaoke bar	Non
friendship	Non
game	Non
competitive	Non
karaoke	Non
asthma	Non
duet	Non
reference to the riddler	Non
singing along with the radio	Non
comic book store	Non
helium	Non
jigsaw puzzle	Non
laundry	Non
elevator shaft	Non
puzzle	Non
riddle	Non
singing	Non
comic book shop	Non
competition	Non
gold coin	Non
smoke	Non
microphone	Non
bowling ball	Non
reference to little house on the prairie	0.0
