game	1.0
airport	1.0
game night	1.0
pictionary	1.0
interrupted sex	1.0
man woman wrestling	1.0
pie eating contest	1.0
long division	1.0
dizzy	1.0
where's waldo puzzle	1.0
climbing out a window	1.0
woman in lingerie	1.0
reference to copernicus	1.0
white board	1.0
unwanted kiss	1.0
wrestling	1.0
reference to casper the friendly ghost	1.0
sick wife	1.0
illness	1.0
sneeze	1.0
return home	1.0
math	1.0
reference to madame curie	1.0
blueberry pie	1.0
pie eating competition	1.0
reference to where's waldo	1.0
pie	1.0
diner	1.0
gender war	1.0
orbital re entry	Non
praying	Non
cameo appearance	Non
sneezing	Non
where's waldo contest	Non
woman wearing a negligee	Non
woman with a cold	Non
red nose	Non
lipstick on a man's cheek	Non
singing in a rocket	Non
astronaut	Non
calling someone a hero	Non
reference to howie mandel	Non
hugging one's friend	Non
fist bump	Non
comic book shop owner	Non
reference to the sound of music	Non
eating pie	Non
singing in a restaurant	Non
falling asleep during sex	Non
tied up while barefoot	Non
yelling	Non
reference to batman	Non
reference to jay leno	Non
cheesecake	Non
hebrew	Non
prayer	Non
