one night stand	1.0
woman initiating sex	1.0
sex with coworker	1.0
liquid nitrogen	1.0
equation	1.0
white board	1.0
rehearsal	1.0
reference to the incredible hulk	Non
sleeping on a couch	Non
reference to ganesh the hindu deity	Non
string quartet	Non
barbeque burger	Non
banana	Non
necktie on a doorknob	Non
seduction	Non
flash frozen	Non
playing a violin	Non
playing cello	Non
mathematical equation	Non
bebop	Non
reference to robert e. lee	Non
reference to abraham lincoln	Non
reference to shiva the hindu deity	Non
reference to godzilla	Non
reference to superman	Non
battle of gettysburg	Non
bazinga	Non
safety glasses	Non
double entendre	Non
war game	Non
