organizer	1.0
letter from father	1.0
cleaning a lint trap	1.0
doing laundry	1.0
woman wearing a little black dress	1.0
reference to the goonies	1.0
letter	1.0
closet	1.0
dinner party	1.0
abandoned by father	1.0
closet organizer	1.0
reference to mad men	1.0
reference to moulin rouge	1.0
burning a letter	1.0
letter from father to son	1.0
box of buttons	Non
cup of tea	Non
can't sleep	Non
smoke detector	Non
giving a boost	Non
human shield	Non
diary	Non
household cleaning gloves	Non
rubber gloves	Non
reference to green lantern	Non
calling someone dude	Non
reference to captain future	Non
reference to batman	Non
calling someone honey	Non
goldfish	Non
dead goldfish	Non
dead fish	Non
party	Non
dinner	Non
thai food	Non
sadness	Non
abandonment	Non
reference to whole foods market	Non
dancing	Non
lint trap	Non
bowling pin	Non
laundry basket	Non
smoke alarm	Non
