human resources	1.0
sexual harassment	1.0
jenga	1.0
giant jenga	Non
reference to kip stephen thorne	Non
reference to john archibald wheeler	Non
playing jenga	Non
reference to albert einstein	Non
t shirt	Non
male singer	Non
playing cello	Non
cafeteria	Non
reference to cap'n crunch	Non
reference to green lantern	Non
jealous girlfriend	Non
waitress uniform	Non
knock pattern	Non
cello	Non
star trek reference	Non
food in episode title	Non
talking to a dog	Non
food in title	Non
reference to captain kirk	Non
reference to star trek	Non
reference to ryan gosling	Non
