boyfriend girlfriend relationship	1.0
tiara	1.0
magic trick	1.0
reference to batman	Non
date night	Non
cover story	Non
magic wand	Non
birthday party	Non
running a red light	Non
playing jenga	Non
reference to xbox 360	Non
diamond bracelet	Non
pocket watch	Non
jewelry store	Non
reference to nathan fillion	Non
reference to green lantern	Non
reference to ryan rodney reynolds	Non
hdtv	Non
playing a video game	Non
yelling	Non
self absorbed	Non
condom	Non
palindrome	Non
quarter the coin	Non
goldfish	Non
