surgery	1.0
deviated septum	1.0
probability of dying	1.0
divorce	1.0
parents getting divorced	Non
playing who am i	Non
snoring	Non
elective surgery	Non
deception	Non
nose bandage	Non
driving a friend to work	Non
urn	Non
bandaged nose	Non
walking into a glass door	Non
power outage	Non
teddy bear	Non
blueberry muffin	Non
waiting room	Non
french toast stick	Non
playing celebrity twenty questions	Non
reference to jay z	Non
urinating in a sink	Non
funerary urn	Non
earthquake	Non
reference to nikola tesla	Non
