reference to chris pratt	1.0
reference to michael jackson	1.0
band breakup	1.0
reference to the fourth of july	1.0
songwriting	1.0
icee	Non
plastic container	Non
top ten list	Non
feeling abandoned	Non
comic book shop	Non
product placement	Non
reference to predator	Non
apartment key	Non
contract	Non
reference to david	Non
reference to goliath	Non
tenant interview	Non
clipboard	Non
thai restaurant	Non
calling someone dude	Non
comic book store	Non
reference to captain future	Non
reference to the flash	Non
comic book shop owner	Non
signing a document	Non
calling someone a weirdo	Non
reference to superman	Non
beer	Non
hug	Non
electronic keyboard	Non
laundry	Non
guitar	Non
character says talk to the hand	Non
flip phone	Non
year 2003	Non
reference to the wizard of oz	Non
reference to geppetto	Non
reference to pinocchio	Non
reference to the tin man	Non
reference to indiana jones	Non
reference to thor	Non
reference to david and goliath	Non
reference to the predator	Non
reference to archie andrews	Non
reference to jughead jones	Non
reference to gandalf	Non
reference to siri	Non
blue icee	Non
