halloween	1.0
paintball	1.0
cosplay	1.0
reference to the hobbit	1.0
halloween episode	Non
halloween party	Non
first kiss	Non
costume party	Non
kiss	Non
insult	Non
chex mix	Non
bare chested male	Non
doppler effect	Non
reference to cathy rigby	Non
wing man	Non
nurse costume	Non
reference to halle berry	Non
shot in the back	Non
bazinga	Non
reference to robin hood	Non
the flash costume	Non
reference to peter pan	Non
caveman costume	Non
cat costume	Non
frodo costume	Non
doppler effect costume	Non
robin hood costume	Non
thor costume	Non
reference to louis leakey	Non
halloween costume	Non
shower	Non
sexy nurse costume	0.0
