gift	1.0
hugging	1.0
reference to krypton the planet	Non
reference to kryptonite	Non
bromance	Non
reference to christmas	Non
reference to hanukkah	Non
reference to speed racer	Non
christmas gift	Non
hugging one's friend	Non
gift exchange	Non
kissing a married man	Non
christmas episode	Non
christmas	Non
ice cream cone	Non
reference to hannibal	Non
autographed napkin	Non
wii bowling	Non
dark matter	Non
leg injury	Non
store	Non
mall	Non
reference to charlie brown	Non
reference to stephen hawking	Non
napkin	Non
reference to leonard nimoy	Non
nintendo wii	Non
reference to zac efron	Non
reference to superman	Non
santa hat	Non
shopping	Non
present	Non
christmas tree	Non
egg nog	Non
rum	Non
christmas present	Non
gift basket	0.0
autograph	0.0
