social media	1.0
car set on fire	1.0
tracing a telephone call	1.0
park bench	1.0
iranian	1.0
reference to iran nuclear deal	1.0
president elect	1.0
reference to google	Non
sitting on a park bench	Non
iranian defector	Non
reference to skype	Non
bag over head	Non
finding a dead body	Non
woman in uniform	Non
hotel suite	Non
episode title spoken by character	Non
gun store	Non
four star general	Non
gun store robbery	Non
reference to instagram	Non
meeting in a park	Non
reference to twitter	Non
reference to facebook	Non
reference to linkedin	Non
limousine driver	Non
telling someone to shut up	Non
threatened with a gun	Non
reference to 4chan	Non
reference to 8chan	Non
throwing away a cell phone	Non
saying thank you	Non
cell phone video	Non
cell phone	Non
bullet hole	Non
kidnapping	Non
calling for backup	Non
breaking glass	Non
mossad	Non
rendition	Non
reference to costa rica	Non
parking permit	Non
troll farm	Non
computer programming	Non
long take	Non
high tech company	Non
job interview	Non
sheriff's department	Non
psychiatrist	Non
abduction	Non
new york city	Non
presidential transition	Non
