iranian	1.0
motel	1.0
supermarket	1.0
depression	1.0
tv show	1.0
lake house	1.0
reference to iran nuclear deal	1.0
reference to the iraq war	1.0
new york city	1.0
president elect	1.0
grazed by a bullet	Non
calling someone a hero	Non
reference to the white house	Non
listening to music on headphones	Non
satellite phone	Non
secretly removing bullets from a gun	Non
removing bullets from a gun	Non
calling someone pal	Non
reference to showtime	Non
german abroad	Non
punched in the stomach	Non
man hits a woman	Non
frisking	Non
secret service agent	Non
thrown to the ground	Non
hit on the head with a tire iron	Non
apology	Non
calling someone an idiot	Non
empty gun	Non
tire iron	Non
view through rifle scope	Non
hiding underwater	Non
shot in the chest	Non
hangar	Non
meeting in a hangar	Non
returning character killed off	Non
mistaken identity	Non
punctuation in episode title	Non
talk radio	Non
political ad	Non
contraband	Non
embarrassment	Non
false identity	Non
adolescent	Non
iraq veteran	Non
sniper	Non
conspiracy	Non
paranoia	Non
foster care	Non
reference to youtube	Non
presidential transition	Non
