fake news	1.0
threat	1.0
flashback	1.0
reference to youtube	1.0
diner	1.0
new york city	1.0
president elect	1.0
waitress	Non
jewelry store	Non
diamond	Non
child welfare worker	Non
peeking through window blinds	Non
secret service agent	Non
voice over letter	Non
range rover	Non
paper chase	Non
ex husband ex wife relationship	Non
ringing a doorbell	Non
leaving message on answering machine	Non
view through rifle scope	Non
cell phone video	Non
cell phone	Non
nickname	Non
gps	Non
propaganda	Non
go bag	Non
troll farm	Non
car service	Non
american flag	Non
security alarm	Non
cafe	Non
internet video	Non
break in	Non
deposition	Non
presidential transition	Non
