protest	1.0
explosion	1.0
tv show	1.0
press conference	1.0
hit by a car	1.0
fake news	1.0
new york city	1.0
president elect	1.0
presidential transition	1.0
view through rifle scope	Non
human acting like a monkey	Non
calling someone a coward	Non
family photograph	Non
pistol whip	Non
computer hacker	Non
secret service agent	Non
protestor	Non
protest sign	Non
reference to adolf hitler	Non
booby trapped door	Non
false online identity	Non
smear campaign	Non
tv interview	Non
hugging one's friend	Non
torture	Non
troll farm	Non
bludgeoned to death	Non
