drone	1.0
fake passport	1.0
tracking device	Non
betrayal	Non
blackmail	Non
extortion	Non
boxer shorts	Non
execution	Non
explosion	Non
father figure	Non
false identity	Non
bed	Non
bribery	Non
bare chested male	Non
shot in the head	Non
riverbed	Non
muslim prayer	Non
bus	Non
u.s. embassy	Non
islamabad pakistan	Non
