keyboard	1.0
friends falling out	1.0
haircut	1.0
electronic keyboard	1.0
two timing	1.0
pay phone	Non
sex with friend's girlfriend	Non
slamming a door shut	Non
margarita	Non
sambuca	Non
hearing characters thoughts	Non
thumbs up gesture	Non
male male hug	Non
truth taken as a joke	Non
reference to starbucks	Non
reference to the beatles	Non
kiss on the lips	Non
interrupted kiss	Non
redheaded woman	Non
canoe	Non
talking to a bird	Non
pet bird	Non
pet duck	Non
duck	Non
playing acoustic guitar	Non
writing a song	Non
acoustic guitar	Non
character name in episode title	Non
