1910s	1.0
1980s	1.0
1970s	1.0
1860s	1.0
severed arm	Non
flashback sequence	Non
field hospital	Non
eavesdropping	Non
obesity	Non
american civil war	Non
extramarital affair	Non
mother son relationship	Non
houseboy	Non
divorce	Non
gay	Non
sunglasses	Non
thanksgiving	Non
nurse	Non
washing dishes	Non
macaroni and cheese	Non
hershey bar	Non
holiday in title	Non
teenage crush	Non
kitchen knife	Non
severed toe	Non
head stuck in turkey	Non
reincarnation	Non
carrot	Non
nose job	Non
turkey the bird	Non
