kiss	1.0
secret romance	1.0
sharing a bathtub	1.0
two in a bath	1.0
shared bath	1.0
photograph	1.0
red rose	1.0
pregnant woman's water breaks	1.0
french kiss	1.0
laundry	1.0
bubble bath	1.0
newlywed	Non
pregnancy	Non
banging on a door	Non
high five	Non
new york city	Non
manhattan new york city	Non
athens greece	Non
picnic	Non
central park manhattan new york city	Non
