sister	1.0
booing	1.0
reference to thor	1.0
husband wife relationship	1.0
reference to erin brockovich	1.0
anniversary	1.0
thesaurus	1.0
letter	Non
letter of recommendation	Non
mockery	Non
crowd	Non
character says i love you	Non
woman proposes marriage	Non
marriage proposal on one's knees	Non
marriage proposal	Non
reference to odin	Non
reference to foot locker	Non
two sisters	Non
madison square garden manhattan new york city	Non
basketball game	Non
getting someone's name wrong	Non
crying baby	Non
grading papers	Non
white male black female relationship	Non
interracial kiss	Non
interracial relationship	Non
reference to pottery barn	Non
reference to the new york knicks	Non
apostrophe in title	Non
airhead	Non
sister sister hug	Non
greeting with hug	Non
female female hug	Non
sister sister conflict	Non
sister sister relationship	Non
baby	Non
babysitting	Non
baby daughter	Non
baby girl	Non
earrings	Non
pierced ear	Non
character name in title	Non
